0,0,0,0,0,0,0,0,0,0,0,0,0,0,0,0,0,0,0,0,0,0,0,0,0,0,0,0,0,0,0,0,0,0,0,0,0,0,0,0,0,0,0,0,0,0,0,0,0,0,0,0,0,0,0,0,0,0,0,0,0,0,0,0,0,0,0,0,0,0,0,0,0,0,0,0,0,0,0,0,0,0,0,0,0,0,0,0,0,0,0,0,0,0,0,0,0,0,0,0,0,0,0,0,0,0,0,0,0,0,0,0,0,0,0,0,0,0,0,0,0,0,0,0,0,0,0,0
0,0,0,0,0,0,0,0,0,0,0,0,0,0,0,0,0,0,0,0,0,0,0,0,0,0,0,0,0,0,0,0,0,0,0,0,0,0,0,0,0,0,0,0,0,0,0,0,0,0,0,0,0,0,0,0,0,0,0,0,0,0,0,0,0,0,0,0,0,0,0,0,0,0,0,0,0,0,0,0,0,0,0,0,0,0,0,0,0,0,0,0,0,0,0,0,0,0,0,0,0,0,0,0,0,0,0,0,0,0,0,0,0,0,0,0,0,0,0,0,0,0,0,0,0,0,0,0
0,0,0,49,49,49,49,49,49,49,49,49,49,0,0,0,0,0,0,0,0,0,0,0,0,0,0,0,0,0,0,0,0,0,0,0,0,0,0,0,0,0,0,0,0,0,0,0,0,0,0,0,0,0,0,0,0,0,0,0,0,0,0,0,0,0,0,0,0,0,0,0,0,0,0,0,0,0,0,0,0,0,0,0,0,0,0,0,0,0,0,0,0,0,0,0,0,0,0,0,0,0,0,0,0,0,0,0,0,0,0,0,0,0,0,0,0,0,0,0,0,0,0,0,0,0,0,0
0,0,47,0,0,0,0,0,0,0,0,0,0,32,0,0,0,0,0,0,0,0,0,0,0,0,0,0,0,0,0,0,0,0,0,0,0,0,0,0,0,0,0,0,0,0,0,0,0,0,0,0,0,0,0,0,0,0,0,0,0,0,0,0,0,0,0,0,0,0,0,0,0,0,0,0,0,0,0,0,0,0,0,0,0,0,0,0,0,0,0,0,0,0,0,0,0,0,0,0,0,0,0,0,0,0,0,0,0,0,0,0,0,0,0,0,0,0,0,0,0,0,0,0,0,0,0,0
0,0,47,0,0,0,0,0,0,0,0,0,0,32,0,0,0,0,0,0,0,0,0,0,0,0,0,0,0,0,0,0,0,0,0,49,49,49,49,49,49,49,49,49,49,49,49,49,49,49,49,0,0,0,0,0,0,0,0,0,0,0,0,0,0,0,0,0,0,0,0,0,0,0,0,0,0,0,0,0,0,0,0,0,0,0,0,0,0,0,0,0,0,0,0,0,0,0,0,0,0,0,0,0,0,0,0,0,0,0,0,0,0,0,0,0,0,0,0,0,0,0,0,0,0,0,0,0
0,0,47,0,0,0,0,0,0,0,0,0,0,32,0,0,0,0,0,0,0,0,0,0,0,0,0,0,0,0,0,0,0,0,63,0,0,0,0,0,0,0,0,0,0,0,0,0,0,0,0,32,0,0,0,0,0,0,0,0,0,0,0,0,0,0,0,0,0,0,0,0,0,0,0,0,0,0,0,0,0,0,0,0,0,0,0,0,0,0,0,0,0,0,0,0,0,0,0,0,0,0,0,0,0,0,0,0,0,0,0,0,0,0,0,0,0,0,0,0,0,0,0,0,0,0,0,0
0,0,47,0,0,0,0,0,0,0,0,0,0,32,0,0,0,0,0,0,0,0,0,0,0,0,0,0,0,0,0,0,0,47,0,0,0,0,0,0,0,0,0,0,0,0,0,0,0,0,0,32,0,0,0,0,0,0,0,0,0,0,0,0,0,0,0,0,0,0,0,0,0,0,0,0,0,0,0,0,0,0,0,0,0,0,0,0,0,0,0,0,0,0,0,0,0,0,0,0,0,0,0,0,0,0,0,0,0,0,0,0,0,0,0,0,0,0,0,0,0,0,0,0,0,0,0,0
0,0,47,0,0,0,0,0,0,0,0,0,0,32,0,0,0,0,0,0,0,0,0,0,0,0,0,0,0,0,0,0,0,47,0,0,0,0,0,0,0,0,0,0,0,0,0,0,0,0,0,48,0,0,0,0,0,0,0,0,0,0,0,0,0,0,0,0,0,0,0,0,0,0,0,0,0,0,0,0,0,0,0,0,0,0,0,0,0,0,0,0,0,0,0,0,0,0,0,0,0,0,0,0,0,0,0,0,0,0,0,0,0,0,0,0,0,0,0,0,0,0,0,0,0,0,0,0
0,0,47,0,0,0,0,0,0,0,0,0,0,48,49,49,49,0,0,0,0,49,49,49,49,49,49,49,49,49,0,0,0,47,0,0,0,0,0,0,0,0,0,0,0,0,0,0,0,0,0,0,48,49,49,49,49,49,49,49,49,49,0,0,0,0,0,0,0,0,0,0,0,0,0,0,0,0,0,0,0,0,0,0,0,0,0,0,0,0,0,0,0,0,0,0,0,0,0,0,0,0,0,0,0,0,0,0,0,0,0,0,0,0,0,0,0,0,0,0,0,0,0,0,0,0,0,0
0,0,47,0,0,0,0,0,0,0,0,0,0,0,0,0,0,32,0,0,47,0,0,0,0,0,0,0,0,0,32,0,0,47,0,0,0,0,0,0,0,0,0,0,0,0,0,0,0,0,0,0,0,0,0,0,0,0,0,0,0,0,32,0,0,0,0,0,0,0,0,0,0,0,0,0,0,0,0,0,0,0,0,0,0,0,0,0,0,0,0,0,0,0,0,0,0,0,0,0,0,0,0,0,0,0,0,0,0,0,0,0,0,0,0,0,0,0,0,0,0,0,0,0,0,0,0,0
0,0,47,0,0,0,0,0,0,0,0,0,0,0,0,0,0,32,0,0,47,0,0,0,0,0,0,0,0,0,32,0,0,47,0,0,0,0,0,0,0,0,0,0,0,0,0,0,0,0,0,0,0,0,0,0,0,0,0,0,0,0,32,0,0,0,0,0,0,0,0,0,0,0,0,0,0,0,0,0,0,0,0,0,0,0,0,0,0,0,0,0,0,0,0,0,0,0,0,0,0,0,0,0,0,0,0,0,0,0,0,0,0,0,0,0,0,0,0,0,0,0,0,0,0,0,0,0
0,0,47,0,0,0,0,0,0,0,183,0,0,0,0,0,0,32,0,0,47,0,0,0,0,0,0,0,0,0,32,0,0,47,0,0,0,0,0,0,0,0,0,0,0,0,0,0,0,0,0,0,0,0,0,183,0,0,0,0,0,0,32,0,0,0,0,0,0,0,0,0,0,0,0,0,0,0,0,0,0,0,0,0,0,0,0,0,0,0,0,0,0,0,0,0,0,0,0,0,0,0,0,0,0,0,0,0,0,0,0,0,0,0,0,0,0,0,0,0,0,0,0,0,0,0,0,0
0,0,47,0,0,0,16,17,17,17,17,17,17,31,0,0,0,32,0,0,47,0,0,0,16,31,0,0,0,0,32,0,0,47,0,0,0,0,0,0,0,0,0,0,0,0,0,0,0,0,0,16,17,17,17,17,17,17,31,0,0,0,32,0,0,0,0,0,0,0,0,0,0,0,0,0,0,0,0,0,0,0,0,49,49,49,0,0,0,0,0,0,0,0,0,0,0,0,0,0,0,0,0,0,0,0,0,0,0,0,0,0,0,0,0,0,0,0,0,0,0,0,0,0,0,0,0,0
0,0,47,0,0,0,32,0,0,0,0,0,0,47,0,0,0,32,0,0,47,0,0,0,32,47,0,0,0,0,32,0,0,47,0,0,0,0,0,0,0,85,0,0,0,0,0,0,0,0,16,0,0,49,49,49,49,49,63,0,0,0,48,49,49,49,49,49,49,49,49,49,49,49,49,49,49,49,49,0,0,0,47,0,0,0,32,0,0,0,0,0,0,0,0,0,0,0,0,0,49,49,49,49,49,49,49,49,0,0,0,0,0,0,0,0,0,0,0,0,0,0,0,0,0,0,0,0
0,0,47,0,0,0,32,0,0,0,0,0,0,47,0,0,0,48,49,49,63,0,0,0,32,47,0,0,0,0,32,0,0,47,0,0,0,0,0,0,0,101,0,0,0,0,0,0,0,0,32,0,47,0,0,0,0,0,0,0,85,0,0,0,0,0,0,0,0,0,0,0,0,0,0,0,0,0,0,32,0,0,47,0,129,0,32,0,0,0,0,0,0,0,0,0,0,0,0,47,0,0,0,0,0,0,0,0,32,0,0,0,0,0,0,0,0,0,0,0,0,0,0,0,0,0,0,0
0,0,47,0,0,0,32,0,0,0,0,0,0,47,0,0,0,0,0,0,0,0,0,0,32,47,0,0,0,0,32,0,0,47,0,1,2,183,4,5,6,7,8,9,10,11,183,13,14,15,32,0,47,0,0,0,0,0,0,0,101,0,0,0,0,0,0,0,0,0,0,0,0,0,0,0,0,0,0,32,0,0,47,0,129,0,32,0,0,0,0,0,0,0,0,0,0,0,0,47,0,0,0,0,0,0,0,0,32,0,0,0,0,0,0,0,0,0,0,0,0,0,0,0,0,0,0,0
0,0,47,0,0,0,32,0,0,0,0,0,0,47,0,0,0,0,0,0,0,0,0,0,32,47,0,0,0,0,32,0,0,0,17,17,17,17,17,17,17,17,17,17,17,17,17,17,17,17,0,0,47,0,0,0,0,0,0,0,0,0,183,0,0,183,0,0,9,10,11,12,13,14,15,0,0,0,0,32,0,0,47,0,129,0,32,0,0,0,0,0,0,0,0,0,0,0,0,47,0,0,0,0,0,0,0,0,32,0,0,0,0,0,0,0,0,0,0,0,0,0,0,0,0,0,0,0
0,0,47,0,0,0,32,0,0,0,0,0,0,47,0,0,0,0,183,183,0,0,0,0,32,47,0,0,0,0,32,0,0,0,0,0,0,0,0,0,0,0,0,0,0,0,0,0,0,0,0,0,47,0,0,0,16,17,17,17,17,17,17,17,17,17,17,17,17,17,17,17,17,17,17,31,0,0,0,32,0,0,47,0,129,0,32,0,0,0,0,0,0,0,0,0,0,0,0,47,0,0,0,0,0,0,0,0,32,0,0,0,0,0,0,0,0,0,0,0,0,0,0,0,0,0,0,0
0,0,47,0,0,0,32,0,0,0,0,0,0,0,17,17,17,17,17,17,17,17,17,17,0,47,0,0,0,0,32,0,0,0,0,0,0,0,0,0,0,0,0,0,0,0,0,0,0,0,0,0,47,0,0,0,32,0,0,0,0,0,0,0,0,0,0,0,0,0,0,0,0,0,0,47,0,0,0,32,0,0,47,144,145,146,32,0,0,0,0,0,0,0,0,0,0,0,0,47,0,0,0,0,0,0,0,0,32,0,0,0,0,0,0,0,0,0,0,0,0,0,0,0,0,0,0,0
0,0,47,0,0,0,32,0,0,0,0,0,0,0,0,0,0,0,0,0,0,0,0,0,0,47,0,0,0,0,32,0,0,0,0,0,0,0,0,0,0,49,49,49,49,49,49,49,49,0,0,0,47,0,0,0,32,0,0,0,0,0,0,0,0,0,0,0,0,0,0,0,0,0,0,47,0,0,0,32,0,0,63,160,161,162,32,0,0,0,0,0,0,0,0,0,0,0,0,47,0,0,0,0,0,0,184,0,32,0,0,0,0,0,0,0,0,0,0,0,0,0,0,0,0,0,0,0
0,0,47,0,0,0,32,0,0,0,49,49,49,49,49,49,49,49,49,49,49,49,49,49,49,63,0,0,0,0,32,0,0,0,0,0,0,0,0,0,63,0,0,0,0,0,0,0,0,48,0,0,47,0,0,0,32,0,0,0,49,49,49,49,49,49,49,49,49,49,49,0,0,0,0,47,0,0,0,32,0,47,178,178,178,178,32,0,0,0,0,0,0,0,0,0,0,0,0,0,17,31,0,0,0,16,17,17,0,0,0,0,0,0,0,0,0,0,0,0,0,0,0,0,0,0,0,0
0,0,47,0,0,0,32,0,0,47,0,0,0,0,0,0,0,0,0,0,0,0,0,0,0,0,0,0,0,0,32,0,0,0,0,0,0,0,49,63,0,0,0,0,0,0,0,0,0,0,48,49,63,0,0,0,32,0,0,63,0,0,0,0,0,0,0,0,0,0,0,32,0,0,0,47,0,0,0,32,0,0,17,31,178,178,32,0,0,0,0,0,0,0,0,0,0,0,0,0,0,47,0,0,0,32,0,0,0,0,0,0,0,0,0,0,0,0,0,0,0,0,0,0,0,0,0,0
0,0,47,0,0,0,32,0,0,47,0,0,0,0,0,0,0,0,0,0,0,0,0,0,0,0,0,0,0,0,32,0,0,0,0,0,0,47,0,0,0,0,0,0,0,0,0,0,0,0,0,0,0,0,0,0,32,0,47,0,0,0,0,0,0,0,0,0,0,0,0,32,0,0,0,47,0,0,0,32,0,0,0,0,17,17,0,0,0,0,0,0,0,0,0,0,0,0,0,0,0,47,0,0,0,32,0,0,0,0,0,0,0,0,0,0,0,0,0,0,0,0,0,0,0,0,0,0
0,0,47,0,0,0,32,0,0,47,0,0,0,0,0,0,0,0,0,0,0,1,2,3,4,5,0,0,0,0,32,0,0,0,0,0,0,47,0,0,0,0,0,0,0,0,0,0,0,0,0,0,0,0,0,0,32,0,47,0,0,0,0,0,0,0,0,0,0,0,0,32,0,0,0,47,0,0,0,32,0,0,0,0,0,0,0,0,0,0,0,0,0,0,0,0,0,0,0,0,0,47,0,0,0,32,0,0,0,0,0,0,0,0,0,0,0,0,0,0,0,0,0,0,0,0,0,0
0,0,47,0,0,0,32,0,0,47,0,0,0,0,0,0,0,0,0,0,16,17,17,17,17,31,0,0,0,16,0,0,0,0,0,0,0,47,0,0,0,0,0,0,0,0,0,0,0,0,0,0,0,0,0,0,32,0,47,0,0,0,0,1,2,3,4,183,183,0,0,32,0,0,0,47,0,0,0,48,49,49,49,49,49,49,49,49,49,49,0,0,0,0,0,0,0,0,0,0,0,47,0,0,0,32,0,0,0,0,0,0,0,0,0,0,0,0,0,0,0,0,0,0,0,0,0,0
0,0,47,0,0,0,32,0,0,47,0,0,0,0,0,0,0,0,0,0,32,0,0,0,0,47,0,0,0,32,0,0,0,0,0,0,0,47,0,184,0,0,183,0,0,0,183,0,0,0,0,0,0,0,0,0,32,0,47,0,0,0,16,17,17,17,17,17,17,17,17,0,0,0,0,47,0,0,0,0,0,0,0,0,0,0,0,0,0,0,32,0,0,0,0,0,0,49,49,49,49,63,0,0,0,32,0,0,0,0,0,0,0,0,0,0,0,0,0,0,0,0,0,0,0,0,0,0
0,0,47,0,0,0,32,0,0,47,0,0,0,183,0,0,0,0,0,0,32,0,0,0,0,47,0,0,0,32,0,0,0,0,0,0,0,0,17,17,17,17,17,17,17,17,17,17,17,17,17,17,17,17,17,17,0,0,47,0,0,0,32,0,0,0,0,0,0,0,0,0,0,0,0,47,0,0,0,0,0,0,85,0,0,0,0,0,0,0,32,0,0,0,0,0,47,0,0,0,0,0,0,0,0,32,0,0,0,0,0,0,0,0,0,0,0,0,0,0,0,0,0,0,0,0,0,0
0,0,47,0,0,0,32,0,0,0,17,17,17,17,17,17,17,17,17,17,0,0,0,0,0,47,0,0,0,32,0,0,0,0,0,0,0,0,0,0,0,0,0,0,0,0,0,0,0,0,0,0,0,0,0,0,0,0,47,0,0,0,32,0,0,0,0,0,0,0,0,0,0,0,0,47,0,0,0,0,0,0,101,0,0,0,0,0,0,0,32,0,0,0,0,0,47,0,0,0,0,0,0,85,0,32,0,0,0,0,0,0,0,0,0,0,0,0,0,0,0,0,0,0,0,0,0,0
0,0,47,0,0,0,32,0,0,0,0,0,0,0,0,0,0,0,0,0,0,0,0,0,0,47,0,0,0,32,0,0,0,0,0,0,0,0,49,49,49,49,49,49,49,49,49,49,49,49,49,49,49,49,49,49,49,49,63,0,0,0,48,49,49,49,49,49,49,49,0,0,0,0,0,47,0,0,0,0,0,0,183,0,0,0,0,0,0,0,32,0,0,0,0,0,47,0,0,0,0,13,183,101,0,32,0,0,0,0,0,0,0,0,0,0,0,0,0,0,0,0,0,0,0,0,0,0
0,0,47,0,0,0,32,0,0,0,0,0,0,0,0,0,0,0,0,0,0,0,49,49,49,63,0,0,0,48,49,49,0,0,0,0,0,47,0,0,0,0,0,0,0,0,0,0,0,0,0,0,0,0,0,0,0,0,0,0,0,0,0,0,0,0,0,0,0,0,32,0,0,0,0,47,0,0,0,16,17,17,17,17,17,31,0,0,0,0,32,0,0,0,0,0,47,0,0,0,16,17,17,17,17,0,0,0,0,0,0,0,0,0,0,0,0,0,0,0,0,0,0,0,0,0,0,0
0,0,63,0,0,0,48,49,49,49,49,49,49,49,49,0,0,49,49,49,49,63,0,0,0,0,0,0,0,0,0,0,32,0,0,0,0,47,0,0,0,0,85,0,0,0,0,0,0,0,0,0,0,0,0,0,0,0,0,0,0,0,0,0,0,0,0,0,0,0,32,0,0,0,0,47,0,0,0,32,0,49,49,49,0,47,0,0,0,0,32,0,0,0,0,0,47,0,0,0,32,0,0,0,0,0,0,0,0,0,0,0,0,0,0,0,0,0,0,0,0,0,0,0,0,0,0,0
0,47,0,0,0,0,0,0,0,0,0,0,0,0,0,32,47,0,0,0,0,0,0,0,0,0,0,0,0,0,0,0,32,0,0,0,0,47,0,0,0,0,101,0,0,0,0,0,0,0,0,0,0,0,0,0,0,0,0,0,0,0,0,0,0,0,0,0,0,0,32,0,0,0,0,47,0,0,0,32,47,0,0,0,32,47,0,0,0,0,32,0,0,0,0,0,47,0,0,0,48,49,49,49,49,0,0,0,0,0,0,0,0,0,0,0,0,0,0,0,0,0,0,0,0,0,0,0
0,47,0,0,0,0,0,0,0,0,0,0,0,0,0,32,47,0,0,0,0,0,0,0,0,0,0,0,0,0,0,0,32,0,0,0,0,47,0,0,0,0,0,0,0,0,0,0,0,183,0,0,1,2,3,4,5,0,0,0,183,0,0,183,0,0,0,0,0,0,32,0,0,0,0,47,0,0,0,32,47,0,3,0,32,47,0,0,0,0,32,0,0,0,0,0,47,0,85,0,0,0,0,0,0,32,0,0,0,0,0,0,0,0,0,0,0,0,0,0,0,0,0,0,0,0,0,0
0,47,0,0,0,0,0,0,0,0,0,0,0,0,0,32,47,0,0,0,0,0,0,0,0,0,0,0,0,0,0,0,32,0,0,0,0,47,0,0,0,0,16,17,17,17,17,17,17,17,17,17,17,17,17,17,17,17,17,17,17,17,17,17,17,17,31,0,0,0,32,0,0,0,0,47,0,0,0,32,47,0,0,184,32,47,0,0,0,0,32,0,0,0,0,0,47,0,101,0,0,0,0,0,0,32,0,0,0,0,0,0,0,0,0,0,0,0,0,0,0,0,0,0,0,0,0,0
0,47,0,0,0,0,0,0,0,0,0,0,0,0,0,32,47,0,0,0,0,0,0,1,2,3,4,5,0,0,183,0,32,0,0,0,0,47,0,0,0,0,32,0,0,0,0,0,0,0,0,0,0,0,0,0,0,0,0,0,0,0,0,0,0,0,47,0,0,0,32,0,0,0,0,47,0,0,0,32,47,0,0,16,0,47,0,0,0,0,32,0,0,0,0,0,47,0,13,14,15,0,0,0,0,32,0,0,0,0,0,0,0,0,0,0,0,0,0,0,0,0,0,0,0,0,0,0
0,47,0,0,0,0,0,0,0,0,0,0,0,0,0,32,47,0,0,0,16,17,17,17,17,17,17,17,17,17,17,17,0,0,0,0,0,47,0,0,0,0,32,0,0,0,0,0,0,0,0,0,0,0,0,0,0,0,0,0,0,0,0,0,0,0,47,0,0,0,32,0,0,0,0,47,0,0,0,32,47,0,0,48,0,47,0,0,0,0,32,0,0,0,0,0,0,17,17,17,17,31,0,0,0,32,0,0,0,0,0,0,0,0,0,0,0,0,0,0,0,0,0,0,0,0,0,0
0,47,0,0,0,0,85,0,0,0,0,0,0,0,0,32,47,0,0,0,32,0,0,0,0,0,0,0,0,0,0,0,0,0,0,0,0,47,0,0,0,0,32,0,0,0,0,0,0,0,0,49,49,49,49,49,49,49,49,49,49,0,0,0,0,0,47,0,0,0,32,0,0,0,0,47,0,0,0,32,47,0,0,0,32,47,0,0,0,0,32,0,0,0,0,0,0,0,0,0,0,47,0,0,0,32,0,0,0,0,0,0,0,0,0,0,0,0,0,0,0,0,0,0,0,0,0,0
0,47,0,0,0,0,101,0,0,0,0,0,0,0,0,32,47,0,0,0,32,0,0,0,0,0,0,0,0,0,0,0,0,0,0,0,0,47,0,0,0,0,32,0,0,0,0,0,0,0,47,0,0,0,0,0,0,0,0,0,0,32,0,0,0,0,47,0,0,0,32,0,0,0,0,47,0,0,0,32,47,0,0,0,32,47,0,0,0,0,32,0,0,0,0,0,0,49,49,49,49,63,0,0,0,32,0,0,0,0,0,0,0,0,0,0,0,0,0,0,0,0,0,0,0,0,0,0
0,47,0,0,183,2,3,4,5,0,185,0,0,0,0,32,47,0,0,0,32,0,0,0,0,0,0,0,0,0,0,0,0,0,0,0,0,47,0,0,0,0,32,0,0,0,0,0,0,0,47,0,0,0,0,0,0,0,0,0,0,48,49,49,49,49,63,0,0,0,32,0,0,0,0,47,0,0,0,32,47,0,0,0,48,63,0,0,0,0,32,0,0,0,0,0,47,0,0,0,0,0,0,0,0,32,0,0,0,0,0,0,0,0,0,0,0,0,0,0,0,0,0,0,0,0,0,0
0,0,17,17,17,17,17,17,17,17,17,17,17,17,17,0,47,0,0,0,32,0,0,0,0,0,0,0,0,49,49,49,49,49,49,49,49,63,0,0,0,0,32,0,0,0,0,0,0,0,47,0,0,0,0,0,0,0,0,0,0,0,0,0,0,0,0,0,0,0,48,49,49,0,0,47,0,0,0,32,47,0,0,0,0,0,0,0,0,0,32,0,0,0,0,0,47,0,0,0,0,0,0,0,0,32,0,0,0,0,0,0,0,0,0,0,0,0,0,0,0,0,0,0,0,0,0,0
0,0,49,49,49,49,49,49,49,49,49,49,0,0,0,0,47,0,0,0,32,0,0,0,0,0,0,0,47,0,0,0,0,0,0,0,0,0,0,0,0,0,32,0,0,0,0,0,0,0,47,0,0,0,0,0,0,0,0,0,0,0,0,0,0,0,0,0,0,0,0,0,0,32,0,47,0,0,0,32,47,0,0,0,0,0,0,0,0,0,32,0,0,0,0,0,47,0,0,0,0,0,183,0,0,32,0,0,0,0,0,0,0,0,0,0,0,0,0,0,0,0,0,0,0,0,0,0
0,47,0,0,0,0,0,0,0,0,0,0,32,0,0,0,47,0,0,0,32,0,0,0,0,0,0,0,63,0,0,0,0,0,0,0,0,0,0,0,0,0,32,0,0,0,0,0,0,0,47,0,0,0,0,0,0,0,0,0,0,0,0,0,0,0,0,0,0,0,0,0,0,32,0,47,0,0,0,32,47,0,183,0,0,0,0,3,0,0,32,0,0,0,0,0,47,0,0,0,16,17,17,17,17,0,0,0,0,0,0,0,0,0,0,0,0,0,0,0,0,0,0,0,0,0,0,0
0,47,0,0,0,0,0,0,0,0,0,0,32,0,0,0,47,0,0,0,32,0,0,49,49,49,49,63,0,0,0,0,0,0,0,0,0,0,85,0,0,0,32,0,0,0,0,0,0,0,47,0,181,0,1,2,3,4,5,6,7,182,9,10,11,12,13,14,15,0,0,0,0,32,0,47,0,0,0,32,0,17,17,17,17,17,17,17,17,17,0,0,0,0,0,0,47,0,0,0,32,0,0,0,0,0,0,0,0,0,0,0,0,0,0,0,0,0,0,0,0,0,0,0,0,0,0,0
0,47,0,0,0,0,0,0,0,0,0,0,32,0,0,0,47,0,0,0,32,0,63,0,0,0,0,0,0,0,0,0,0,0,0,0,0,0,101,0,0,0,32,0,0,0,0,0,0,0,0,17,17,17,17,17,17,17,17,17,17,17,17,17,17,17,17,17,17,31,0,0,0,32,0,47,0,0,0,32,0,0,0,0,0,0,0,0,0,0,0,0,0,0,0,0,47,0,0,0,32,0,0,0,0,0,0,0,0,0,0,0,0,0,0,0,0,0,0,0,0,0,0,0,0,0,0,0
0,47,0,0,0,0,0,0,0,0,0,0,32,0,0,0,47,0,0,0,48,63,0,0,0,0,0,0,0,0,0,0,0,183,0,0,1,2,3,4,5,0,32,0,0,0,0,0,0,0,0,0,0,0,0,0,0,0,0,0,0,0,0,0,0,0,0,0,0,47,0,0,0,32,0,47,0,0,0,32,0,0,0,0,0,0,0,0,0,0,0,0,0,0,0,0,47,0,0,0,32,0,0,0,0,0,0,0,0,0,0,0,0,0,0,0,0,0,0,0,0,0,0,0,0,0,0,0
0,47,0,0,0,0,0,0,0,0,0,0,32,0,0,0,47,0,0,0,0,0,0,0,0,0,0,0,0,0,0,0,16,17,17,17,17,17,17,17,17,17,0,0,0,0,0,0,0,0,0,0,0,49,49,49,0,0,0,0,0,0,0,0,0,0,0,0,0,47,0,0,0,32,0,47,0,0,0,32,0,0,0,0,0,0,0,0,0,0,0,0,0,0,0,0,47,0,0,0,32,0,0,0,0,0,0,0,0,0,0,0,0,0,0,0,0,0,0,0,0,0,0,0,0,0,0,0
0,47,0,0,0,0,0,0,183,0,0,0,32,0,0,0,47,0,0,0,0,0,0,0,0,0,0,0,0,0,0,0,32,0,0,0,0,0,0,0,0,0,0,0,0,0,0,0,0,0,0,0,47,0,0,0,32,0,0,0,0,0,0,0,0,0,0,0,0,47,0,0,0,48,49,63,0,0,0,48,49,49,49,49,49,49,49,49,49,49,49,49,49,49,49,49,63,0,0,0,32,0,0,0,0,0,0,0,0,0,0,0,0,0,0,0,0,0,0,0,0,0,0,0,0,0,0,0
0,47,0,0,0,16,17,17,17,17,17,17,0,0,0,0,47,0,183,0,183,0,0,0,0,0,0,0,0,0,0,0,32,0,0,0,0,0,0,0,0,0,0,0,0,0,0,0,0,0,0,0,47,0,129,0,32,0,0,0,0,0,0,0,0,0,0,0,0,47,0,0,0,0,0,0,0,0,0,0,0,0,0,0,0,0,0,0,0,0,0,0,0,0,0,0,0,0,0,0,32,0,0,0,0,0,0,0,0,0,0,0,0,0,0,0,0,0,0,0,0,0,0,0,0,0,0,0
0,47,0,0,0,32,0,0,0,0,0,0,0,0,0,0,0,17,17,17,17,17,17,17,31,0,0,0,0,0,0,0,48,49,49,49,49,49,49,49,49,49,49,49,49,49,49,49,49,49,0,0,47,0,129,0,32,0,0,0,0,0,0,0,0,0,0,0,0,47,0,0,0,0,0,0,0,0,0,0,0,0,0,0,0,0,0,0,0,0,0,0,0,0,0,0,0,0,0,0,32,0,0,0,0,0,0,0,0,0,0,0,0,0,0,0,0,0,0,0,0,0,0,0,0,0,0,0
0,47,0,0,0,32,0,0,0,0,0,0,0,0,0,0,0,0,0,0,0,0,0,0,0,31,0,0,0,0,0,0,0,0,0,0,0,0,0,0,0,0,0,0,0,0,0,0,0,0,32,0,47,0,129,0,32,0,0,0,0,0,0,0,0,0,0,0,0,47,0,0,0,0,0,1,2,3,4,5,6,183,8,9,10,11,0,0,0,0,0,0,0,0,0,183,0,0,3,0,32,0,0,0,0,0,0,0,0,0,0,0,0,0,0,0,0,0,0,0,0,0,0,0,0,0,0,0
0,47,0,0,0,32,0,0,0,0,0,0,0,0,0,0,0,0,0,0,0,0,0,0,0,0,17,17,31,0,0,0,0,0,0,0,0,0,0,0,85,0,0,0,0,0,0,0,0,0,32,0,47,0,129,0,32,0,0,0,0,0,0,0,0,0,0,0,0,47,0,0,0,16,17,17,17,17,17,17,17,17,17,17,17,17,31,0,0,0,16,17,17,17,17,17,17,17,17,17,0,0,0,0,0,0,0,0,0,0,0,0,0,0,0,0,0,0,0,0,0,0,0,0,0,0,0,0
0,47,0,0,0,32,0,0,0,0,0,0,0,0,0,0,0,0,0,0,0,0,0,0,0,0,0,0,47,0,0,0,0,0,0,0,0,0,0,0,101,0,0,0,0,0,0,0,0,0,32,0,47,144,145,146,32,0,49,49,49,49,49,49,49,49,49,0,0,47,0,0,0,32,0,0,0,0,0,0,0,0,0,0,0,0,47,0,0,0,32,0,0,0,0,0,0,0,0,0,0,0,0,0,0,0,0,0,0,0,0,0,0,0,0,0,0,0,0,0,0,0,0,0,0,0,0,0
0,47,0,0,0,32,0,0,0,0,0,0,0,0,0,0,0,0,0,0,0,0,0,0,0,0,0,0,47,0,0,0,0,1,2,183,4,5,6,7,8,183,10,11,12,183,14,15,0,0,32,0,63,160,161,162,32,47,0,0,0,0,0,0,0,0,0,32,0,47,0,0,0,32,0,0,0,0,0,0,0,0,0,0,0,0,47,0,0,0,32,0,0,0,0,0,0,0,0,0,0,0,0,0,0,0,0,0,0,0,0,0,0,0,0,0,0,0,0,0,0,0,0,0,0,0,0,0
0,47,0,0,0,32,0,0,0,0,0,0,0,0,0,0,0,0,0,0,0,0,0,0,0,0,0,0,0,17,17,17,17,17,17,17,17,17,17,17,17,17,17,17,17,17,17,17,17,17,0,47,178,178,178,178,32,47,0,0,0,0,0,0,0,0,0,32,0,47,0,0,0,32,0,0,0,0,0,0,0,0,0,0,0,0,47,0,0,0,48,49,49,49,49,49,0,0,0,0,0,0,0,0,0,0,0,0,0,0,0,0,0,0,0,0,0,0,0,0,0,0,0,0,0,0,0,0
0,47,0,0,0,32,0,0,0,0,0,0,0,0,0,0,0,0,0,0,0,0,0,0,0,0,0,0,0,0,0,0,0,0,0,0,0,0,0,0,0,0,0,0,0,0,0,0,0,0,0,0,17,31,178,178,32,47,0,0,0,0,0,0,0,0,0,32,0,47,0,0,0,32,0,0,0,0,0,0,0,0,0,0,0,0,47,0,0,0,0,0,0,0,0,0,32,0,0,0,0,0,0,0,0,0,0,0,0,0,0,0,0,0,0,0,0,0,0,0,0,0,0,0,0,0,0,0
0,47,0,0,0,32,0,0,0,0,0,0,0,0,0,0,0,0,0,0,0,0,0,0,0,0,0,0,0,0,0,0,0,0,0,0,0,0,0,0,0,0,0,0,0,0,0,0,0,0,0,0,0,0,17,17,0,47,0,0,0,0,0,0,183,0,0,32,0,47,0,0,0,32,0,0,0,0,0,0,49,49,49,49,49,49,63,0,0,0,0,0,0,0,0,0,32,0,0,0,0,0,0,0,0,0,0,0,0,0,0,0,0,0,0,0,0,0,0,0,0,0,0,0,0,0,0,0
0,47,0,0,0,48,49,49,49,49,49,49,49,49,0,0,0,0,0,0,0,0,0,0,0,0,0,0,0,0,0,0,0,0,0,0,0,0,0,0,0,0,0,0,0,0,0,0,0,0,0,0,0,0,0,0,0,47,0,0,0,16,17,17,17,17,17,0,0,47,0,0,0,32,0,0,0,0,0,63,0,0,0,0,0,0,0,0,0,0,0,0,0,0,0,0,32,0,0,0,0,0,0,0,0,0,0,0,0,0,0,0,0,0,0,0,0,0,0,0,0,0,0,0,0,0,0,0
0,47,0,0,0,0,0,0,0,0,0,0,0,0,48,49,49,49,49,49,49,49,49,49,49,49,49,49,49,49,49,49,49,49,49,49,49,49,49,49,49,49,49,49,49,49,49,49,49,49,49,49,49,49,49,49,49,63,0,0,0,48,49,49,49,49,49,49,49,63,0,0,0,32,0,0,0,0,47,0,0,0,0,0,0,0,0,0,0,85,0,0,0,0,0,0,32,0,0,0,0,0,0,0,0,0,0,0,0,0,0,0,0,0,0,0,0,0,0,0,0,0,0,0,0,0,0,0
0,47,0,0,0,0,0,0,0,0,0,0,0,0,0,0,0,0,0,0,0,0,0,0,0,0,0,0,0,0,0,0,0,0,0,0,0,0,0,0,0,0,0,0,0,0,0,0,0,0,0,0,0,0,0,0,0,0,0,0,0,0,0,0,0,0,0,0,0,0,0,0,0,32,0,0,0,0,47,0,0,0,0,0,0,0,0,0,0,101,0,0,0,0,0,0,32,0,0,0,49,49,49,0,0,0,0,0,0,0,0,0,0,0,0,0,0,0,0,0,0,0,0,0,0,0,0,0
0,47,0,0,85,0,0,0,0,0,0,0,0,0,0,0,0,0,0,0,0,85,0,0,0,0,0,0,0,0,0,0,0,0,0,0,85,0,0,0,0,0,0,0,0,0,0,0,0,85,0,0,0,0,0,0,0,0,0,0,0,0,0,0,0,0,0,0,0,0,0,85,0,32,0,0,0,0,47,0,0,0,0,0,9,10,11,12,13,14,15,183,183,0,0,0,32,0,0,47,0,0,0,32,0,0,0,0,0,0,0,0,0,0,0,0,0,0,0,0,0,0,0,0,0,0,0,0
0,47,0,0,101,0,0,0,0,0,0,0,0,0,0,0,0,0,0,0,0,101,0,0,0,0,0,0,0,0,0,0,0,0,0,0,101,0,0,0,0,0,0,0,0,0,0,0,0,101,0,0,0,0,0,0,0,0,0,0,0,0,0,0,0,0,0,0,0,0,0,101,0,32,0,0,0,0,47,0,0,0,16,17,17,17,17,17,17,17,17,17,17,17,17,17,0,0,0,47,0,129,0,32,0,0,0,0,0,0,0,0,0,0,0,0,0,0,0,0,0,0,0,0,0,0,0,0
0,47,0,0,1,2,3,4,5,0,0,0,183,0,0,183,0,0,0,1,2,3,4,5,6,0,0,0,0,183,2,3,4,5,6,7,8,9,183,11,12,13,14,15,183,0,0,0,0,183,0,0,0,0,183,0,0,0,1,2,3,4,5,6,183,8,9,10,11,12,13,14,15,32,0,0,0,0,47,0,0,0,32,0,0,0,0,0,0,0,0,0,0,0,0,0,0,0,0,47,0,129,0,32,0,0,0,0,0,0,0,0,0,0,0,0,0,0,0,0,0,0,0,0,0,0,0,0
0,0,17,17,17,17,17,17,17,17,17,17,17,17,17,17,17,17,17,17,17,17,17,17,17,17,17,17,17,17,17,17,17,17,17,17,17,17,17,17,17,17,17,17,17,17,17,17,17,17,17,17,17,17,17,17,17,17,17,17,17,17,17,17,17,17,17,17,17,17,17,17,17,0,0,0,0,0,47,0,0,0,32,0,0,0,0,0,0,0,0,0,0,0,0,0,0,0,0,47,0,129,0,32,0,0,0,0,0,0,0,0,0,0,0,0,0,0,0,0,0,0,0,0,0,0,0,0
0,0,0,0,0,0,0,0,0,0,0,0,0,0,0,0,0,0,0,0,0,0,0,0,0,0,0,0,0,0,0,0,0,0,0,0,0,0,0,0,0,0,0,0,0,0,0,0,0,0,0,0,0,0,0,0,0,0,0,0,0,0,0,0,0,0,0,0,0,0,0,0,0,0,0,0,0,0,47,0,0,0,32,0,0,0,0,0,0,0,0,0,0,0,0,0,0,0,0,47,0,129,0,32,0,0,0,0,0,0,0,0,0,0,0,0,0,0,0,0,0,0,0,0,0,0,0,0
0,0,0,0,0,0,0,0,0,0,0,0,0,0,0,0,0,0,0,0,0,0,0,0,0,0,0,0,0,0,0,0,0,0,0,0,0,0,0,0,0,0,0,0,0,0,0,0,0,0,0,0,0,0,0,0,0,0,0,0,0,0,0,0,0,0,0,0,0,0,0,0,0,0,0,0,0,0,47,0,0,0,32,0,0,0,0,0,0,0,0,0,0,0,0,0,0,0,0,47,144,145,146,32,0,0,0,0,0,0,0,0,0,0,0,0,0,0,0,0,0,0,0,0,0,0,0,0
0,0,0,0,0,0,0,0,0,0,0,0,0,0,0,0,0,0,0,0,0,0,0,0,0,0,0,0,0,0,0,0,0,0,0,0,0,0,0,0,0,0,0,0,0,0,0,0,0,0,0,0,0,0,0,0,0,0,0,0,0,0,0,0,0,0,0,0,0,0,0,0,0,0,0,0,0,0,47,0,0,0,32,0,0,0,0,49,49,49,0,0,0,0,0,0,0,0,0,63,160,161,162,32,0,0,0,0,0,0,0,0,0,0,0,0,0,0,0,0,0,0,0,0,0,0,0,0
0,0,0,0,0,0,0,0,0,0,0,0,0,0,0,0,0,0,0,0,0,0,0,0,0,0,0,0,0,0,0,0,0,0,0,0,0,0,0,0,0,0,0,0,0,0,0,0,0,0,0,0,0,0,0,0,0,0,0,0,0,0,0,0,0,0,0,0,0,0,0,0,0,0,0,0,0,0,47,0,0,0,32,0,0,0,47,0,0,0,32,0,0,0,0,0,0,0,47,178,178,178,178,32,0,0,0,0,0,0,0,0,0,0,0,0,0,0,0,0,0,0,0,0,0,0,0,0
0,0,0,0,0,0,0,0,0,0,0,0,0,0,0,0,0,0,0,0,0,0,0,0,0,0,0,0,0,0,0,0,0,0,0,0,0,0,0,0,0,0,0,0,0,0,0,0,0,0,0,0,0,0,0,0,0,0,0,0,0,0,0,0,0,0,0,0,0,0,0,0,0,0,0,0,0,0,47,0,0,0,48,49,49,49,63,0,128,0,48,0,0,0,0,0,0,0,0,17,31,178,178,32,0,0,0,0,0,0,0,0,0,0,0,0,0,0,0,0,0,0,0,0,0,0,0,0
0,0,0,0,0,0,0,0,0,0,0,0,0,0,0,0,0,0,0,0,0,0,0,0,0,0,0,0,0,0,0,0,0,0,0,0,0,0,0,0,0,0,0,0,0,0,0,0,0,0,0,0,0,0,0,0,0,0,0,0,0,0,0,0,0,0,0,0,0,0,0,0,0,0,0,0,0,0,47,0,0,0,0,85,0,0,0,0,130,0,0,32,0,0,0,0,0,0,0,0,0,17,17,0,0,0,0,0,0,0,0,0,0,0,0,0,0,0,0,0,0,0,0,0,0,0,0,0
0,0,0,0,0,0,0,0,0,0,0,0,0,0,0,0,0,0,0,0,0,0,0,0,0,0,0,0,0,0,0,0,0,0,0,0,0,0,0,0,0,0,0,0,0,0,0,0,0,0,0,0,0,0,0,0,0,0,0,0,0,0,0,0,0,0,0,0,0,0,0,0,0,0,0,0,0,0,47,0,0,0,0,101,0,0,0,0,130,0,0,32,0,0,0,0,0,0,0,0,0,0,0,0,0,0,0,0,0,0,0,0,0,0,0,0,0,0,0,0,0,0,0,0,0,0,0,0
0,0,0,0,0,0,0,0,0,0,0,0,0,0,0,0,0,0,0,0,0,0,0,0,0,0,0,0,0,0,0,0,0,0,0,0,0,0,0,0,0,0,0,0,0,0,0,0,0,0,0,0,0,0,0,0,0,0,0,0,0,0,0,0,0,0,0,0,0,0,0,0,0,0,0,0,0,0,47,9,10,11,12,13,14,15,183,183,147,0,0,32,0,0,0,0,0,0,0,0,0,0,0,0,0,0,0,0,0,0,0,0,0,0,0,0,0,0,0,0,0,0,0,0,0,0,0,0
0,0,0,0,0,0,0,0,0,0,0,0,0,0,0,0,0,0,0,0,0,0,0,0,0,0,0,0,0,0,0,0,0,0,0,0,0,0,0,0,0,0,0,0,0,0,0,0,0,0,0,0,0,0,0,0,0,0,0,0,0,0,0,0,0,0,0,0,0,0,0,0,0,0,0,0,0,0,0,17,17,17,17,17,17,17,17,17,17,17,17,0,0,0,0,0,0,0,0,0,0,0,0,0,0,0,0,0,0,0,0,0,0,0,0,0,0,0,0,0,0,0,0,0,0,0,0,0
